11111111111111111111
10000000000000000001
10000000000000000001
10000000000000000001
10000000000000000001
10000000000000000001
10000000000000000001
10000000000000000001
10000000000000000001
10000000000000000001
10000000000000000001
10000000000000000001
10000000000000000001
100000000000C000C001
10000000000000000001
10000000000000000001
10000000000000000001
10000000000E0000P001
10000000000000000001
11111111111111111111
