11111111111111111111
10010000000000000001
101C1000000000000001
10010000000000000001
10000000000000000001
10000000000000000001
10000000000000000001
10000000000000000001
10000000000000000001
10000000000000000001
10000000000000000001
10000000000000000001
10000000000000000001
100000000000C0000001
10000000000000000001
10000000000000000001
10000000000000000001
100000000000E000P001
10000000000000000001
11111111111111111111
