11111111111111111111
10010000000000000001
10101000000000000001
10010000000000000001
10000000000000000001
10000000000000000001
10000000000000000001
10000000000000000001
10000000000000000001
10000000000000000001
10000000000000000001
10000000000000000001
10000000000000000001
10000000000000000001
10000000000000000001
10000000000000000001
10000000000111100001
10000000001ECP100001
10000000000111100001
11111111111111111111
